Aalto	Alvar
Aarons	Slim
Abbey	Edwin Austin
Abercrombie	Gertrude
Abramović	Marina
Abts	Tomma
Acconci	Vito
Achenbach	Andreas
Ackroyd	Norman
Adams	Ansel
Adams	Arthur
Adams	Neal
Adamski	Josh
Addams	Charles
Adnan	Etel
Adolfsson	Mattias
Aenami	Alena
Aertsen	Pieter
af Klint	Hilma
Affandi	N/A
Afremov	Leonid
Agam	Yaacov
Agar	Eileen
Agasse	Jacques-Laurent
Aitchison	Craigie
Aitken	Doug
Aivazovsky	Ivan
Aja	David
Akrami	Sherry
Alakbarov	Rashad
Albers	Anni
Albers	Josef
Albi	Alessio
Albright	Ivan
Albuquerque	Rafael
Aldridge	Miles
Alemany	Alex
Alexander	John White
Allingham	Helen
Allori	Alessandro
Allred	Mike
Alm	Nick
Alma-Tadema	Lawrence
Alvarado	Lilia
Alzamora	Emil
Amano	Yoshitaka
Amer	Ghada
Amiet	Cuno
Amor	Rick
Amorsolo	Fernando
Anacleto	Jay
Anatsui	El
Ancher	Anna
Ancher	Michael
Andersen	Hans Christian
Andersen	Sarah
Anderson	Richard
Anderson	Sophie
Anderson	Wes
Ando	Tadao
Andreev	Alex
Andrews	Esao
Angelico	Fra
Angrand	Charles
Anguissola	Sofonisba
Aniela	Miss
Anker	Albrecht
Anning	Mary
Anquetin	Louis
Ansell	Mary Jane
Ansin	Martin
Antoni	Janine
Aoshima	Chiho
Apterus	Sabbas
Arad	Ron
Aragonés	Sergio
Araki	Hirohiko
Araki	Nobuyoshi
Aramaki	Shinji
Arbus	Diane
Arcangel	Cory
Archillect	N/A
Archipenko	Alexander
Arcimboldo	Giuseppe
Ardon	Mordecai
Argyle	Steve
Arian	Mark
Arkhipov	Abram Efimovich
Arkley	Howard
Armstrong	Rolf
Arnegger	Alois
Arnold	Eve
Arntz	Gerd
Arntzenius	Floris
Aroch	Guy
Aronson	Ben
Arp	Jean
Arrivabene	Agostino
Arsham	Daniel
Artgerm	N/A
Asai	Miki
Asano	Inio
Ascher	Clemens
Asencio	Henry
Atget	Eugène
Atroshenko	Andrew
Audubon	John James
Auerbach	Frank
Ault	George
Avercamp	Hendrick
Averin	Alexandr
Avery	Milton
Avery	Tex
Azzopardi	Deborah
Baars	Ingrid
Backer	Harriet
Bacon	Francis
Bagge	Peter
Bagshaw	Tom
Bailly	Alice
Bak	Karol
Bakshi	Ralph
Bakst	Léon
Balaskas	Christopher
Baldridge	Jamie
Baldung	Hans
Balfour	Ronald
Balivet	Emily
Balke	Peder
Balla	Giacomo
Balthus	N/A
Baluschek	Hans
Bana	Benedick
Banksy	N/A
Barbarelli da Castelfranco	Giorgio
Barbey	Thomas
Barbier	George
Barker	Cicely Mary
Barker	Clive
Barks	Carl
Barlach	Ernst
Barlow	Phyllida
Barlowe	Wayne
Barnes	Ernie
Barnet	Will
Barns-Graham	Wilhelmina
Barrett	Angela
Barry	Lynda
Barson	Paul
Bartlett	Bo
Basch	Peter
Baselitz	Georg
Basquiat	Jean-Michel
Bassano	Jacopo
Basse	Willem
Bassman	Lillian
Bastien-Lepage	Jules
Bateman	Robert
Bates	David
Batho	John
Batoni	Pompeo
Bauer	John
Baugh	Casey
Baumann	Gustave
Baumeister	Willi
Bawden	Edward
Bayer	Herbert
Bazille	Frederic
Beal	Gifford
Beale	Mary
Bean	Alan
Bearden	Romare
Beardsley	Aubrey
Beaton	Cecil
Beaton	Kate
Beauvarlet	Jacques-Firmin
Beaux	Cecilia
Bechdel	Alison
Becket-Griffith	Jasmine
Beckmann	Max
Beecroft	Vanessa
Beeple	N/A
Beksiński	Zdzisław
Bell	Julie
Bell	Vanessa
Bellmer	Hans
Bellotto	Bernardo
Benglis	Lynda
Benjamin-Constant	Jean-Joseph
Benois	Albert
Benois	Alexandre
Benson	Ambrosius
Benson	Frank Weston
Berenstain	Stan
Bergh	Richard
Berkey	John
Bernard	Émile
Bernhard	Ruth
Bernini	Gian Lorenzo
Bertoia	Harry
Beskow	Elsa
Beuckelaer	Joachim
Beuys	Joseph
Bevan	Robert
Bierstadt	Albert
Biggers	John T.
Bilal	Enki
Bilibin	Ivan
Billout	Guy
Binkley	Ed
Birch	Simon
Bisley	Simon
Blackman	Charles
Blackmon	Julie
Blackshear	Thomas
Blackwood	Algernon
Blair	Mary
Blake	Quentin
Blake	William
Blanchard	Antoine
Blanche	John
Bleda	Elsa
Blossfeldt	Karl
Bluhm	Norman
Bluth	Don
Boccioni	Umberto
Böcklin	Arnold
Bofill	Ricardo
Bolles	Enoch
Bomberg	David
Bonestell	Chesley
Bonhomme	Olivier
Bonnard	Pierre
Booth	Franklin
Bordalo	Artur
Bordalo II	N/A
Borelli da Caluso	Guido
Borgeaud	Marius
Borromini	Francesco
Bors	Matt
Borsi	Flora
Bosch	Hieronymus
Bosma	Sam
Bosschaert	Ambrosius
Bosschart	Johfra
Botticelli	Sandro
Boudin	Eugène
Bouguereau	William-Adolphe
Boulet	Susan Seddon
Boulle	Andre-Charles
Bourgeois	Louise
Bowater	Charlie
Boyd	Arthur
Boyle	Eleanor Vere
Bradley	Noah
Brancusi	Constantin
Bratby	John
Brauer	Bill
Brauner	Victor
Briclot	Aleksi
Briggs	Austin
Briggs	Raymond
Briscoe	Mark
Britto	Romero
Brohm	Joachim
Brom	Gerald
Brooks	Mark
Brown	Ford Madox
Brown	Lucy Madox
Brown	Patrick
Brubaker	Ed
Bruegel the Elder	Pieter
Brunelleschi	Filippo
Buchet	Gustave
Buchholz	Quint
Buffet	Bernard
Burch	Laurel
Burchfield	Charles E.
Burdeny	David
Burdisio	Alejandro
Buren	Daniel
Burlet	Richard
Burliuk	David
Burne-Jones	Edward
Burns	Jim
Burri	Alberto
Burroughs	William S.
Burton	Tim
Bussière	Gaston
Butcher	Kaethe
Butto	Saturno
Byerley	Bob
Cabanel	Alexandre
Caesar	Ray
Cahun	Claude
Cai	Zhichao
Calame	Alexandre
Calatrava	Santiago
Caldecott	Randolph
Caldwell	Clyde
Callahan	Harry
Callebaut	Vincent
Camoin	Charles
Campau	Mike
Campbell	Eddie
Campin	Robert
Campion	Pascale
Canaletto	N/A
Canete	Eric
Canova	Antonio
Capek	Josef
Capp	Al
Cappiello	Leonetto
Caravaggio	N/A
Carle	Eric
Carlsen	Emil
Carlson	Larry
Carman	Bill
Carmichael	Franklin
Carnwath	Squeak
Carpeaux	Jean-Baptiste
Carracci	Annibale
Carrington	Dora
Carson	Michael
Carus	Carl Gustav
Caruso	Santiago
Casas	Ramon
Casorati	Felice
Cassaday	John
Cassatt	Mary
Casson	A. J.
Catalano	Bruno
Catherall	Paul
Caulfield	Patrick
Cavanaugh	Robby
Celmins	Vija
Cézanne	Paul
Chabas	Paul
Chagall	Marc
Chamberlain	John
Chambers	Tom
Chassériau	Théodore
Chast	Roz
Chausheva	Katia
Chaykin	Howard
Cheng	Hsiao-Ron
Cheng	Yanjun
Cheval	Michael
Chevrier	Sandra
Chicago	Judy
Childish	Billy
Chipperfield	David
Cho	Frank
Christensen	James C.
Church	Frederic Edwin
Ciurlionis	Mikalojus Konstantinas
Claesz	Pieter
Clampett	Bob
Claremont	Chris
Clark	Alson Skinner
Clark	Amanda
Clark	Lygia
Clarke	Harry
Claudel	Camille
Claus	Emile
Close	Chuck
Cole	Thomas
Coley	Nathan
Collishaw	Mat
Conrad	Tony
Constable	John
Cooke	Darwyn
Cooper	Colin Campbell
Corben	Richard
Corcos	Vittorio Matteo
Cordal	Isaac
Corfield	Paul
Corinth	Lovis
Cormon	Fernand
Cornell	Joseph
Cornish	Norman
Cornwell	Dean
Corot	Camille
Costras	Dorina
Coulson	Peter
Courbet	Gustave
Cranach the Elder	Lucas
Crane	Walter
Craola	N/A
Crepax	Guido
Crewdson	Gregory
Criswell	Debbie
Crivelli	Carlo
Cross	Henri-Edmond
Crowe	Victoria
Cruikshank	George
Crumb	Robert
Cunningham	Chris
Currin	John
Cushart	Krenz
da Cortona	Pietro
da Vinci	Leonardo
Dadd	Richard
Dahl	Johan Christian
Dahl-Wolfe	Louise
Daines	Sherree Valentine
Dalí	Salvador
Dalrymple	Farel
Darger	Henry
Darrow	Geof
Daubigny	Charles-Francois
Daumier	Honoré
Davenport	Ian
David	Gerard
Davidson	Bruce
Davis	Jack
Davis	Jim
Davis	Marc
Davis	Stuart
Davison	Craig
Dawe	Gabriel
Day	Walter Percy
Dayer	Diego
de Boulogne	Valentin
de Champaigne	Philippe
de Chirico	Giorgio
de Heem	Jan Davidsz
de Hooch	Pieter
De Keyser	Raoul
de Kooning	Elaine
de Kooning	Willem
de La Fresnaye	Roger
de La Tour	Georges
de Lempicka	Tamara
De Morgan	Evelyn
de Nittis	Giuseppe
de Ribera	Jusepe
de Stael	Nicolas
de Toulouse-Lautrec	Henri
de Vlaminck	Maurice
Deacon	Richard
Deakins	Roger
Dean	Roger
DeCarava	Roy
Deconnick	Kelly Sue
DeFeo	Jay
Deforge	Michael
Degas	Edgar
Deharme	Lise
del Piombo	Sebastiano
Delacroix	Eugene
Delaney	Beauford
Delaunay	Sonia
Dell'otto	Gabriele
della Francesca	Piero
della Robbia	Luca
Delort	Nicolas
Delvaux	Paul
Delville	Jean
Delvoye	Wim
Demetz	Aron
Demizu	Posuka
Denning	Guy
Deodato	Mike
Derain	Andre
Deschambault	Martin
Desiderio	Vincent
Despain	Brian
Detmold	Charles Maurice
Detmold	Edward Julius
Dewailly	Anne
Di Fate	Vincent
Diebenkorn	Richard
Dillon	Steve
Disher	Mandy
Disney	Walt
DiTerlizzi	Tony
Ditko	Steve
Dittmann	Anna
Dix	Otto
Dmitriev	Dima
do Amaral	Tarsila
Dodd	Thomas
Doig	Peter
Donley	Ray
Donoghue	Adrian
Donwood	Stanley
Doré	Gustave
Dorman	Dave
Dougherty	Patrick
Dove	Arthur
Doyle	Richard
Doyle	Tim
Drepina	Natalia
Driskell	David
Druillet	Philippe
Drysdale	TJ
Dubuffet	Jean
Duchamp	Marcel
Duchamp-Villon	Raymond
Ducreux	Joseph
Dulac	Edmund
Duncan	John
Duncanson	Robert S.
Dupain	Max
Durand	Asher Brown
Dürer	Albrecht
Dyce	William
Eakins	Thomas
Eames	Ray
Eardley	Joan
Earle	Eyvind
Earles	Amy
Earley	Lori
Easley	Jeff
Eastman	Michael
Easton	Timothy
Echelman	Janet
Edelfelt	Albert
Edgerton	Harold
Edlin	Tyler
Edmiston	Jason
Edwards	Les
Eek	Piet Hein
Eggleston	William
Eggleton	Bob
Eisenman	Nicole
Eisenman	Peter
Eisenstaedt	Alfred
Eisner	Will
Ejsing	Jesper
El Greco	N/A
Elgort	Arthur
Eliasson	Olafur
Ellger	Christine
Ellis	Dean
Ellis	Warren
Elmore	Larry
Elorza	Joseba
Elsheimer	Adam
Elson	Peter
Elvgren	Gil
Emin	Tracey
Emshwiller	Ed
Enckell	Magnus
Endresen	Daria
Eng	Kilian
Engle	Jason A.
Enjolras	Delphin
Enrich	Victor
Ensor	James
Epting	Steve
Erlich	Leandro
Ernst	Max
Ernst	Rudolf
Errazuriz	Sebastian
Erwitt	Elliott
Escher	M.C.
Espedal	Truls
Etchells	Tim
Etty	William
Eurich	Richard
Evans	Cerith Wyn
Evans	Walker
Eversen	Adrianus
Fabry	Glenn
Fadeev	Anton
Fairey	Shepard
Fairhurst	Andy
Falero	Luis Ricardo
Falter	John Philip
Fantin-Latour	Henri
Farquharson	Joseph
Faulkner	Iain
Faust	Lauren
Fedden	Mary
Fehn	Sverre
Feininger	Lyonel
Feitelson	Lorser
Feldstein	Al
Fenton	Joe
Ferez	Andrew
Ferri	Roberto
Ferris	Emil
Ferriss	Hugh
Finch	David
Fini	Leonor
Fink	Callie
Fink	Larry
Finlay	Virgil
Finnstark	Anato
Finster	Howard
Fischer	Anton Otto
Fischer	Paul Gustav
Fischinger	Oskar
Fischl	Eric
Fisher	Samuel Melton
Fitzgerald	John Anster
Fitzpatrick	Tony
Flandrin	Hippolyte
Flavin	Dan
Fleischer	Max
Flinck	Govaert
Flint	Alex Russell
Flint	William Russell
Floris	Frans
Foglio	Kaja
Foglio	Phil
Fonssagrives	Fernand
Fontana	Franco
Fontana	Lavinia
Fontana	Lucio
Forain	Jean-Louis
Forbes	Stanhope
Ford	Henry Justice
Fortescue-Brickdale	Eleanor
Foss	Chris
Foster	Hal
Foster	Jon
Foster	Myles Birket
Foster	Norman
Fouquet	Jean
Fox	Toby
Fraction	Matt
Fragonard	Alexandre-Évariste
Fragonard	Jean-Honoré
Frahm	Art
Francis	Sam
Francken the Younger	Frans
Frank	Lisa
Franke	Andreas
Frankenthaler	Helen
Frazetta	Frank
Freas	Kelly
Freeman	Ed
Freud	Lucian
Friedrich	Caspar David
Friel	Chris
Frieseke	Frederick Carl
Frissell	Toni
Frith	William Powell
Froud	Brian
Froud	Wendy
Fruin	Tom
Fuchs	Ando
Fuchs	Ernst
Fujimoto	Sou
Fujita	Goro
Fuller	Buckminster
Fusco	Paul
Fuseli	Henry
Gacy	John Wayne
Gadd	Elizabeth
Gaiman	Neil
Gainsborough	Thomas
Gallé	Émile
Gammell	Stephen
Gangloff	Hope
Garber	Daniel
Garcin	Gilbert
Garmash	Inessa
Garmash	Michael
Gaudí	Antoni
Gaughan	Jack
Gauguin	Paul
Gaulli	Giovanni Battista
Ge	Nikolai
Geary	Emma
Geddes	Anne
Geddes	Jeremy
Gehry	Frank
Gekas	Bill
Gentileschi	Artemisia
Gentileschi	Orazio
Gerard	Justin
Gerhartz	Daniel F.
Géricault	Théodore
Gérôme	Jean-Léon
Gerstner	Karl
Gertler	Mark
Ghailan	Atey
Ghenie	Adrian
Giacometti	Alberto
Giancola	Donato
Gibbons	Dave
Gifford	Sanford Robinson
Giger	H. R. (Hans Ruedi)
Gilleard	James
Gillen	Kieron
Gillett	Leticia
Gilliam	Sam
Gillick	Liam
Gillmor	Robert
Giordano	Luca
Giorgione	N/A
Giotto	N/A
Girard	Greg
Girardet	Eugène
Giraud	Jean
Girodet	Anne-Louis
Glaser	Milton
Glendening	Alfred Augustus
Glinn	Burt
Globepainter	Seth
Gluck	Gerhard
Gluckmann	Grigory
Goble	Warwick
Godward	John William
Godwin	Fay
Gogo	Basil
Golan	Emek
Goldberger	Sacha
Goldblatt	David
Goldin	Nan
Goldsworthy	Andy
Goltzius	Hendrick
Goncharova	Natalia
Gonsalves	Rob
Gonzalez	Josan
Goodall	Frederick
Goodwin	Albert
Goossens	Ben
Gordiets	Evgeni
Gordin	Misha
Gores	Derek
Gorey	Edward
Gorky	Arshile
Gorny	Hein
Goya	Francisco
Graafland	Scarlett Hooft
Graber	Carrie
Grandville	J. J.
Grasset	Eugène
Grasso	Laurent
Graverol	Jane
Graves	Abbott Fuller
Graves	Mab
Greasley	Laurie
Greenaway	Kate
Gregoire	Kenne
Grelle	Martin
Grey	Alex
Gric	Peter
Griffiths	Carne
Grigoriev	Boris
Grimm	Brothers
Grimshaw	John Atkinson
Grimwood	Tracie
Grindat	Henriette
Gris	Juan
Groening	Matt
Gropius	Walter
Gropper	William
Grosz	George
Grünewald	Matthias
Guay	Rebecca
Guibert	Hervé
Guichard-Bunel	Jeannette
Guidice	Rick
Guillaumin	Armand
Gupta	Subodh
Gurney	James
Guston	Philip
Guthrie	Sir James
Guttuso	Renato
Gwathmey	Charles
Haas	Ernst
Hacker	Arthur
Hadid	Zaha
Haeckel	Ernst
Hagan	Robert
Hall	Sydney Prior
Hals	Frans
Halsman	Philippe
Hamaguchi	Mao
Hambling	Maggi
Hamilton	Richard
Hammershoi	Vilhelm
Hammick	Tom
Hammons	David
Hang	Ren
Hanks	Steve
Hanson	Erin
Hanuka	Asaf
Hanuka	Tomer
Hardy	Bert
Hardy	David A.
Hardy	Heywood
Haring	Keith
Harper	Charley
Harris	John
Harris	Lawren
Harrison	Florence
Harrison	L. Birge
Hartley	Marsden
Hartung	Hans
Harvey	Harold
Hase	Ryohei
Haseltine	William Stanley
Hashimoto	Jacob
Hassam	Childe
Hatke	Ben
Hatoum	Mona
Hattori	Naoto
Hawkes	Pam
Hawkesworth	Jamie
Haygarth	Stuart
Hayter	Stanley William
Heade	Martin Johnson
Heathcote	Peregrine
Heatherwick	Thomas
Heckel	Erich
Heda	Willem Claesz.
Hedley	Paul
Hegarty	Valerie
Heilmann	Mary
Heizer	Michael
Hejduk	John
Helnwein	Gottfried
Henderson	Steve
Hendricks	Barkley L.
Henle	Fritz
Henry	Paul
Henson	Bill
Hepworth	Barbara
Heron	Patrick
Herrera	Carolina
Herriman	George
Heward	Prudence
Hewett	Ryan
Hewlett	Jamie
Hewton	Randolph Stanley
Heysen	Nora
Hideyoshi	Lorenz
Hildebrandt	Brothers
Hildebrandt	Greg
Hildebrandt	Tim
Hillier	Dan
Hillier	Steve
Hirano	Miho
Hirémy-Hirschl	Adolf
Hironaka	Harumi
Hoch	Hannah
Hockney	David
Hodas	Filip
Hodgkin	Howard
Hodler	Ferdinand
Hogarth	William
Hokusai	Katsushika
Holl	Frank
Holl	Steven
Holme III	Peter
Holsoe	Carl
Homer	Winslow
Hopper	Edward
Horkey	Aaron
Horley	Alex
Horna	Kati
Hornel	Edward Atkinson
Horsley	Ralph
Howe	John
Howland	Meghan
Howson	Peter
Hoyland	John
Huanca	Donna
Hughes	Arthur
Hughes	Edward Robert
Hundertwasser	Friedensreich Regentag Dunkelbunt
Hunt	William Henry
Hunt	William Holman
Hurtado	Fabio
Hutter	Michael
Huynh	Duy
Hyde	Catherine
Icart	Louis
Ikeda	Ryoji
Immonen	Stuart
Inceoglu	Ismail
Indiana	Robert
Ingels	Bjarke
Ingres	Jean Auguste Dominique
Inness	George
Inshaw	David
Ionut	Caras
Irwin	Robert
Ishinomori	Shotaro
Ito	Junji
Ito	Toyo
Itten	Johannes
Iwerks	Ub
Izu	Kenro
Jaar	Alfredo
Jacklin	Bill
Jacrot	Christophe
Jaems	Daniel
Janmot	Louis
Janson	Klaus
Janssens	Frieke
Jansson	Alexander
Jansson	Tove
Jasinski	Aaron
Jean	James
Jeffers	Oliver
Jeffries	Lee
Jensen	Georg
Jevtic	Bojan
Jewett	Ellen
Jia	Ruan
Jiaying	He
Jimenez	Phil
Jingna	Zhang
Joffe	Chantal
Joffe	Constantin
Johanna	Martine
Johansson	Erik
John	Augustus
John	Gwen
Johns	Geoff
Johns	Jasper
Johnson	Eastman
Johnson	Richard S.
Johnston	Alfred Cheney
Johnstone	Dorothy
Jones	Android
Jones	Erik
Jones	Francis Coates
Jones	Gerald Harvey
Jones	Jeffrey Catherine
Jones	Peter Andrew
Jordaens	Jacob
Jorn	Asger
Jover	Loui
Judd	Amy
Judd	Donald
Judge	Mike
Julien	Isaac
Jullien	Jean
Jung	Matthias
Jung Gi	Kim
Jurgens	Mandy
Jusko	Joe
Kago	Shintaro
Kahlo	Frida
Kahn	Louis
Kahraman	Hayv
Kairiukstis	Vytautas
Kalf	Willem
Kaluta	M.W.
Kander	Nadav
Kandinsky	Wassily
Kaneko	Jun
Kaphar	Titus
Karcz	Michal
Kashin	Wadim
Katsuya	Terada
Kaur	Rupi
Kawasaki	Audrey
Kawase	Hasui
Keane	Glen
Keane	Margaret
Keathley	Mark
Kechun	Zhang
Keever	Kim
Kehoe	Andy
Keller	Ferdinand
Kelley	Mike
Kelly	Ellsworth
Kelly	Ken
Kelly	Walt
Kemp	Peter
Kennington	Thomas Benjamin
Kenny	Alan
Kensett	John Frederick
Kent	Rockwell
Kentridge	William
Kepes	György
Kern	Geof
Kerstens	Hendrik
Kesinger	Brian
Ketner	Jeremiah
Khakhar	Bhupen
Khare	Adonna
Khnopff	Fernand
Kiefer	Anselm
Kielland	Kitty Lange
Kieth	Sam
Kikuchi	Hideyuki
Kilburne	George Goodwin
Killion	Tom
Kinkade	Thomas
Kinney	Jeff
Kippenberger	Martin
Kirby	Jack
Kirchner	Ernst Ludwig
Kiuchi	Tatsuro
Klarwein	Mati
Klassen	Jon
Klee	Paul
Klein	Steven
Klein	William
Klein	Yves
Kleiner	Carl
Kley	Heinrich
Klimczak	Dariusz
Klimt	Gustav
Kline	Franz
Knab	Ferdinand
Knaths	Karl
Kneller	Godfrey
Kngwarreye	Emily Kame
Knight	Chad
Knight	Daniel Ridgway
Knight	Nick
Knoop	Helene
Koch	Phil
Kohn	Andre
Koike	Kazuo
Kojima	Ayami
Kokoschka	Oskar
Kollwitz	Käthe
Kon	Satoshi
Koons	Jeff
Korovin	Konstantin
Kossoff	Leon
Kotak	Bella
Kowch	Andrea
Krasner	Lee
Kretschmer	Hugh
Kreyn	Maria
Kruger	Barbara
Kubin	Alfred
Kubrick	Stanley
Kuczynski	Pawel
Kuma	Kengo
Kunisada	N/A
Kuniyoshi	Utagawa
Kuniyoshi	Yasuo
Kunkle	Brad
Künstler	Mort
Kupka	Frantisek
Kurzgesagt	N/A
Kusama	Yayoi
Kush	Vladimir
Kustanovich	Dmitry
Kuvshinov	Ilya
Kyōsai	Kawanabe
La Farge	John
LaChapelle	David
Lacombe	Georges
Lacoste	Raphael
Laffoley	Paul
Lagerstedt	Mikko
Lagorio	Lev
Lagrange	Marc
Lague	Mark
Lalique	René
Lam	Wifredo
Land	Greg
Landseer	Edwin Henry
Lange	Dorothea
Langley	Clint
Langley	Walter
Larionov	Mikhail
Larkin	William
Larraín	Sergio
Larraz	Julio
Larriva	John
Larson	Abigail
Larson	Gary
Larson	Jeffrey T.
Larsson	Carl
Lartigue	Jacques Henri
Lasdun	Denys
Lasker	Jonathan
Lassnig	Maria
Lathrop	Dorothy
Lathrop	William Langson
Launay	Melissa
Laurencin	Marie
Lavery	John
Law	Rebecca Louise
Lawlor	Jimmy
Lawrence	Don
Lawrence	Jacob
Lawrence	Thomas
Lawson	Ernest
Le Brun	Charles
Le Fauconnier	Henri
Le Parc	Julio
Le Sidaner	Henri
Le Sueur	Eustache
Lear	Edward
Lecouffe-Deharme	Bastien
Lee	Alan
Lee	Jim
Lee-Merrion	Harriet
Leech	Raymond
Leen	Nina
Lefler	Heinrich
Lega	Silvestro
Leger	Fernand
Legg	Jeff
Lehr	Paul
Leib	Chris
Leibovitz	Annie
Leighton	Edmund
Leighton	Frederick Lord
Lemire	Jeff
Levitan	Isaac
Leyendecker	J.C.
Lhote	André
Lichtenstein	Roy
Lieber	Steve
Liefeld	Rob
Liepke	Malcolm
Ligare	David
Lijun	Fang
Lilien	Ephraim Moses
Lindner	Richard
Lindsay	Norman
Lipking	Jeremy
Lippi	Filippino
Lipton	Laurie
Lisowski	Michal
List	Herbert
Listfield	Scott
Loboda	Taras
Loftis	Cory
Loir	Luigi
Lorusso	Joseph
Lossel	Yoann
Louie	Travis
Lovecraft	H.P.
Lovering	Paul
Lovett	Mark
Lucas	George
Luce	Maximilien
Luks	George
Lushpin	Evgeny
Lux	Loretta
Lynch	Albert
Lynch	David
Lyon	Danny
Maar	Dora
Mably	Brandon
Macara	Andrew
Macke	August
Mackintosh	Charles Rennie
Mackintosh	Margaret Macdonald
Maclean	Rachel
MacLeod	Pegi Nicol
Madgwick	Clive
Madgwick	Lee
Madureira	Joe
Maes	Nicolaes
Magee	Fintan
Magritte	Rene
Maher	Patty
Mahfood	Jim
Maier	Vivian
Maimon	Isaac
Maitz	Don
Major	Akos
Majorelle	Louis
Makabresku	Laura
Makovsky	Nikolay
Malczewski	Jacek
Maleev	Alex
Malevich	Kazimir
Mallett	Keith
Malm	Michael
Manara	Milo
Mandelbrot	Benoit B.
Manet	Édouard
Manguin	Henri
Mann	Jeremy
Mann	Sally
Mantegna	Andrea
Mapplethorpe	Robert
Marc	Franz
Marcoussis	Louis
Marden	Brice
Mark	Mary Ellen
Markin	Andrei
Marquet	Albert
Mars	Chris
Marseus van Schrieck	Otto
Marsh	Reginald
Marshall	Kerry James
Marshennikov	Serge
Marsone	Meredith
Martin	Agnes
Martin	John
Martinakis	Adam
Martinière	Stephan
Mashburn	Brian
Masson	André
Matisse	Henri
Matsumoto	Leiji
Matsumoto	Taiyō
Matta	Roberto
Matthews	Rodney
Mattingly	David B.
Matutina	Dan
Max	Peter
Mayhew	Mike
Mazzoni	Marco
McCaffrey	Anne
McCall	Robert
McFarlane	Todd
McGinley	Ryan
McGinnis	Robert
McGuire	Richard
McKean	Dave
McKelvie	Jamie
McKernan	Kelly
McKie	Angus
McMaster	Meryl
McPharlin	Dan
McPherson	Tara
McQuarrie	Ralph
McQue	Ian
Mead	Syd
Medcalf	Bill
Meireles	Cildo
Mell	Ed
Mendoza	Eddie
Menzel	Adolph
Merian	Maria Sibylla
Merlo	Monia
Merriam	Daniel
Metcalf	Willard
Metzinger	Jean
Meyerdierks	Carsten
Michelangelo	N/A
Mignard	Nicolas
Mignola	Mike
Mili	Gjon
Millen	Anja
Miller	Frank
Miller	Ian
Miller	Marjorie
Millet	Jean-François
Milligan	Peter
Mills	Russ
Miró	Joan
Mirza	Haroon
Mistric	Trish
Miura	Kentaro
Miyazaki	Hayao
Modersohn-Becker	Paula
Modigliani	Amedeo
Modlin	Margaret
Moebius	N/A
Moholy-Nagy	László
Mohrbacher	Peter
Mondrian	Piet
Monet	Claude
Monge	Jean-Baptiste
Monkman	Kent
Monks	Alyssa
Moon	Sailor
Moore	Alan
Moore	Albert Joseph
Moore	Chris
Moore	Henry
Moore	Tony
Mora	Briana
Moralis	Yiannis
Moran	Thomas
Moreau	Gustave
Moret	Henry
Morgan	Gwenda
Moriyama	Daido
Moross	Aries
Morrice	James Wilson
Morris	Desmond
Morris	William
Morski	Igor
Mortensen	John Kenn
Moscoso	Victor
Moses	Grandma
Mosina	Inna
Motherwell	Robert
Moureaux	Emmanuelle
Mucha	Alphonse
Mueck	Ron
Mullins	Craig
Mulready	Augustus Edwin
Mumford	Dan
Munari	Bruno
Munch	Edvard
Munnings	Alfred
Munro	Bruce
Münter	Gabriele
Munthe	Gerhard
Murakami	Takashi
Muray	Nickolas
Murciano	Patrice
Murillo	Bartolomé Esteban
Musin	Sergey
Muth	Jon J
Mutu	Wangechi
Muybridge	Eadweard
Nagai	Go
Nagai	Hiroshi
Nagao	Yoh
Nagel	Patrick
Nagy	Tibor
Naismith	Scott
Najjar	Serge
Nan	Juliana
Nares	James
Nash	Paul
Nasmith	Ted
Nason	Pieter
Nast	Thomas
Nauck	Todd
Nauman	Bruce
Nay	Ernst Wilhelm
Neel	Alice
Neer	Ildiko
Neffati	Rimel
Negley	Keith
Neiman	LeRoy
Nelson	Kadir
Nelson	R. Kenton
Nerdrum	Odd
Neshat	Shirin
Nesterov	Mikhail
Neto	Ernesto
Nevinson	C. R. W.
Newland	Jane
Newman	Barnett
Newton	Helmut
Ngai	Victo
Nguyen	Dustin
Nguyen	Tran
Nicholson	Ben
Nicholson	William
Nickerson	Dee
Nicolle	Florian
Nielsen	Kay
Niemeyer	Oscar
Nihei	Tsutomu
Nilsson	Bertil
Nirasawa	Yasushi
Nizovtsev	Victor
Noguchi	Isamu
Nolan	Sidney
Noland	Kenneth
Nolde	Emil
Nolin	Catherine
Nomura	Tetsuya
Nordahl	David
Nordqvist	Sven
Norem	Earl
North	Marianne
Norton	Andre
Noto	Phil
Nouvel	Jean
O'Keeffe	Georgia
O'Neill	Terry
Oakes	Terry
Obata	Takeshi
Ocampo	Octavio
Oda	Eiichiro
Ofili	Chris
Ohara	Koson
Ohman	Jack
Ohrai	Noriyoshi
Oiticica	Helio
Ojala	Eiko
Okamura	Tim
Okanoue	Toshiko
Okon	Marek
Okubo	Naomi
Okuń	Edward
Oldenburg	Claes
Olgiati	Valerio
Olley	Margaret
Olschinsky	Atelier
Olsen	Greg
Opie	Julian
Oppenheim	Méret
Oprisco	Oleg
Orkin	Ruth
Ormandy	Stephen
Orozco	José Clemente
Orrico	Tony
Osbert	Alphonse
OSGEMEOS	N/A
Oshii	Mamoru
Oszvald	Noell
Otomo	Katsuhiro
Otomo	Shohei
Ottley	Ryan
Oum	Siya
Oursler	Tony
Outhwaite	Ida Rentoul
Outram	Steven
Owens	Rick
Oxer	William
Ozeri	Yigal
Paick	James
Paik	Nam June
Paine	Roxy
Palha	Rui
Palmer	Walter Launt
Palumbo	David
Panton	Verner
Pantone	Felipe
Papapetrou	Polixeni
Paraskeva	Elena
Parker	Cornelia
Parkes	Michael
Parkinson	Keith
Parkinson	Norman
Parks	Gordon
Parmigianino	N/A
Parr	Martin
Parreno	Philippe
Parrish	Maxfield
Parry	Alan
Parsons	Alfred
Pascin	Jules
Pasmore	Victor
Pasquini	Alice
Patinir	Joachim
Patrick	James McIntosh
Pattnaik	Sudersan
Pawson	John
Peale	Charles Willson
Peale	Raphaelle
Pearlstein	Philip
Pearson	Jason
Pechstein	Max
Peeters	Clara
Pei	Guo
Pellegrini	Pierre
Pelletier	Paul
Pelton	Agnes Lawrence
Pemba	George
Penn	Irving
Pennington	Bruce
Perceval	John
Percival	Anja
Perez	Fabian
Perez	George
Permeke	Constant
Perry	Grayson
Perry	Lilla Cabot
Pesce	Gaetano
Peterson	Cleon
Peterssen	Eilif
Pether	Abraham
Petolas	Nikolina
Phillips	Coles
Picabia	Francis
Picasso	Pablo
Pieck	Anton
Pillon	Klaus
Pinchon	Robert Antoine
Pinter	Ferenc
Piper	John
Pippin	Horace
Piranesi	Giovanni Battista
Piraro	Dan
Pirner	Maximilian
Piskor	Ed
Pissarro	Camille
Pissarro	Lucien
Pitre	John
Plensa	Jaume
Point	Armand
Poiret	Paul
Polacco	Patricia
Pollock	Jackson
Pontormo	N/A
Ponzi	Emiliano
Popova	Lyubov
Portinari	Candido
Potter	Beatrix
Potter	Paulus
Prager	Alex
Pranckevicius	Gediminas
Prendergast	Maurice
Procter	Dod
Pugh	Gareth
Puvis de Chavannes	Pierre
Pyle	Howard
Quesada	Joe
Quilty	Ben
Quinn	Marc
Quitely	Frank
Rackham	Arthur
Rader	Paul
Raeburn	Henry
Rahon	Alice
Rak	Martin
Rand	Paul
Ranson	Paul
Raphael	N/A
Rauschenberg	Robert
Ravilious	Eric
Ray	Man
Razell	Aliza
Rea	Joel
Redlin	Terry
Redmond	Granville
Redon	Odilon
Redondo	Vicente Romero
Reggianini	Vittorio
Rego	Paula
Reiffel	Charles
Rekunenko	Valentin
Remington	Frederic
Remnev	Andrey
Reni	Guido
Renoir	Pierre-Auguste
Renshaw	David
Repin	Ilya
Ressia	Romina
Restout the Younger	Jean
Reuss	John
Rew	Stephanie
Reynolds	Joshua
RHADS	N/A
Rhead	Louis
Ribemont-Dessaignes	Georges
Richards	William Trost
Richter	Gerhard
Riddell	Chris
Rigaud	Hyacinthe
Rigney	Brad
Riley	Bridget
Ringgold	Faith
Riopelle	Jean-Paul
Ríos	Emma
Rippl-Rónai	József
Rist	Pipilotti
Ritts	Herb
Rivera	Diego
Rivière	Briton
ROA	N/A
Robert	Hubert
Roberts	Tom
Robinson	Andrew
Robinson	Charles
Robinson	Frederick Cayley
Robinson	W. Heath
Rocha	Andreas
Rockwell	Norman
Roerich	Nicholas
Rolando	Cyril
Romney	George
Ronner-Knip	Henriëtte
Roosegaarde	Daan
Roset	Conrad
Ross	Alex
Ross	Bob
Rossetti	Dante Gabriel
Rossier	Jessica
Rotari	Pietro Antonio
Rotella	Mimmo
Roth	Ed
Rothen	Marianna
Rothenstein	Anne
Rothko	Mark
Rouault	Georges
Rousse	Georges
Rousseau	Henri
Roversi	Paolo
Rowland	Jeff
Royo	Luis
Różalski	Jakub
Ruas	Joao
Rubell	Jennifer
Rubens	Peter Paul
Rucka	Greg
Rutkowski	Greg
Ryden	Mark
Ryder	Albert Pinkham
Saarinen	Eero
Saeki	Toshio
Saenredam	Jan Pietersz
Saenredam	Pieter Jansz
Safdie	Moshe
Sage	Amanda
Sage	Kay
Saintclair	Apollonia
Sajedi	Afarin
Saliot	Thomas
Salminen	John
Samnee	Chris
Samori	Nicola
San Miguel	Okuda
Sander	August
Sandys	Frederick
Sapiro	Maurice
Saraceno	Tomás
Saray	Rebeca
Sarazhin	Denis
Sardax	N/A
Sargent	John Singer
Sart	Tony
Saryan	Martiros
Sasamoto	Masaaki
Sassen	Viviane
Satrapi	Marjane
Saudek	Jan
Saville	Jenny
Saville	Peter
Savrasov	Aleksey
Savvas	Nike
Scarpa	Carlo
Scarry	Richard
Schad	Christian
Schalcken	Godfried
Schaller	Thomas W
Schapiro	Miriam
Scharf	Kenny
Schatz	Howard
Schatzberg	Jerry
Scheffer	Ary
Scherer	Kees
Schiele	Egon
Schjerfbeck	Helene
Schloe	Christian
Schmidt-Rottluff	Karl
Schoonhoven	Johannes Jan
Schorr	Todd
Schuiten	Francois
Schulz	Charles
Schutz	Dana
Schwabe	Carlos
Schwitters	Kurt
Scully	Sean
Sculthorpe	Peter
Seago	Edward
Searle	Ronald
Seaut	Cedric
Sedlacek	Franz
Sedlar	Janek
Segal	George
Segantini	Giovanni
Seignac	Guillaume
Semenov	Anton
Sendak	Maurice
Serebriakova	Zinaida
Serov	Valentin
Seurat	Georges
Seuss	Dr.
Seveso	Alberto
Shaden	Brooke
Shahn	Ben
Sharp	Liam
Shau	Natalie
Shaw	Barclay
Shepard	E. H.
Sherman	Cindy
Shields	Tyler
Shimoda	Hikari
Shinkai	Makoto
Shinkawa	Yoji
Shinkhai	Makoto
Shinn	Everett
Shinoyama	Kishin
Shiota	Chiharu
Shirow	Masamune
Shishkin	Ivan
Shoen	Uemura
Shonibare	Yinka
Shore	Stephen
Shumate	Tim
Shuster	Joe
Shwedoff	Yuri
Sieff	Jeanloup
Siegel	Jerry
Sienkiewicz	Bill
Sillman	Amy
Silvestri	Marc
Simion	Felicia
Simkins	Greg
Simonetti	Marc
Singer	Andy
Siswanto	Rudy
Skoglund	Sandy
Slaby	Reylia
Sloan	John French
Sloan	Kevin
Smilde	Berndnaut
Smith	Adrian
Smith	Barry Windsor
Smith	Douglas
Smith	Grace Cossington
Smith	Jeffrey
Smith	Jessie Willcox
Smith	Kiki
Smith	Pamela Colman
Snyder	Zack
Solomon	Simeon
Sorayama	Hajime
Sorolla	Joaquín
Sottsass	Ettore
Soudain	Annie
Soutine	Chaïm
Souto	Arturo
Sowa	Michael
Spare	Austin Osman
Sparth	N/A
Spencelayh	Charles
Spiegelman	Art
Spitzweg	Carl
Spoor	Nathan
Spriggs	David
Stalenhag	Simon
Stanhope	John Roddam Spencer
Steadman	Ralph
Steer	Philip Wilson
Stegman	Ryan
Steichen	Edward
Steig	William
Stelfreeze	Brian
Stella	Frank
Stella	Joseph
Stern	Irma
Sternfeld	Joel
Sterrett	Virginia Frances
Stevens	Dave
Stevenson	ND
Stillman	Marie Spartali
Stivers	Robert
Stokes	Anne
Stokoe	James
Stookey	Ann
Storch	Sally
Stout	William
Strand	Paul
Streeton	Arthur
Strid	Linnea
Struzan	Drew
Stubbs	George
Suarez	Tatiana
Sugimori	Ken
Sugimoto	Hiroshi
Sultan	Larry
Sum	Brian
Sutherland	Graham
Suuronen	Matti
Swanland	Raymond
Swynnerton	Annie
Sze	Sarah
Szukalski	Stanisław
Takahashi	Rumiko
Takamatsu	Kazuki
Takenaga	Barbara
Takeuchi	Naoko
Tamaki	Jillian
Tamayo	Rufino
Tan	Shaun
Tanguy	Yves
Tanner	Henry Ossawa
Tanning	Dorothea
Tarbell	Edmund
Tardi	Jacques
Taro	Gerda
Tarrant	Percy
Tartakovsky	Genndy
Tavernier	Jules
Taylor	Jason deCaires
teamLab	N/A
Teasdale	Malcolm
Telgemeier	Raina
Teller	Juergen
Templesmith	Ben
Teniers the Younger	David
Tenniel	John
ter Borch	Gerard
Testino	Mario
Tezuka	Osamu
Thaulow	Frits
Thayer	Abbott Handerson
theCHAMBA	N/A
Theurer	Heather
Thiebaud	Wayne
Thieme	Anthony
Thole	Karel
Thoma	Hans
Thomas	Mickalene
Thomson	Tom
Thorburn	Archibald
Thorgerson	Storm
Thorne	Frank
Tice	George
Tichenor	Bridget Bate
Tichý	Miroslav
Tiepolo	Giovanni Battista
Tiepolo	Giovanni Domenico
Tiffany	Louis Comfort
Timm	Bruce
Tindle	David
Tintoretto	N/A
Tissot	James
Titian	N/A
Tito	Ettore
Toft	Sam
Tomine	Adrian
Tomino	Yoshiyuki
Tooker	George
Toriyama	Akira
Toth	Alex
Toth	Emerico Imre
Toussaint	Fernand
Tran	Ross
Traquair	Phoebe Anna
Traylor	Bill
Treacy	Philip
Trotter	Kathryn Morris
Truitt	Anne
Turner	J.M.W.
Turner	Pete
Turrell	James
Uccello	Paolo
Uglow	Euan
Uhlig	Daniela
Uminga	Chris
Uno	Aquirax
Urasawa	Naoki
Urschel	Jan
Ury	Lesser
Utamaro	Kitagawa
Utrillo	Maurice
Vacher	Christophe
Valadon	Suzanne
Valdi	Thiago
Vallejo	Boris
Valls	Dino
Valluzzi	Regina
Valsecchi	Olivier
Valtat	Louis
van Aelst	Willem
Van Allsburg	Chris
van Asch	Pieter-Jansz
van Baarle	Lois
van Bloemen	Jan Frans
Van de Woestijne	Gustave
Van den Berghe	Frits
van der Rohe	Ludwig Mies
van Doesburg	Theo
van Dongen	Kees
van Dyck	Anthony
van Eyck	Jan
van Gogh	Vincent
van Goyen	Jan
van Haecht	Willem
van Helten	Guido
van Herpen	Iris
van Honthorst	Gerard
van Hoogstraten	Samuel
Van Hove	Francine
van Kessel the Elder	Jan
van Ostade	Adriaen
van Ray	Amandine
van Rijn	Rembrandt
van Ruisdael	Jacob
van Ruysdael	Salomon
van Rysselberghe	Theo
Van Sciver	Ethan
van Scorel	Jan
van Utrecht	Adriaen
van Verendael	Nicolaes
van Wieck	Nigel
Vandervell	Rupert
Varo	Remedios
Vasarely	Victor
Vasari	Giorgio
Vasconcelos	Joana
Vasnetsov	Apollinary
Vasnetsov	Viktor
Vaughan	Brian K.
Vedder	Elihu
Veeber	Kuno
Veith	Eduard
Velázquez	Diego
Venanzi	Giovanni Battista
Ventrue	Eve
Vermeer	Johannes
Vernet	Horace
Veronese	Paolo
Vess	Charles
Vigée Le Brun	Élisabeth
Villon	Jacques
Viola	Bill
Vishniac	Roman
Viveros	Brian M.
Vogelsang	Elke
von Guerard	Eugene
von Jawlensky	Alexej
von Unwerth	Ellen
von Werefkin	Marianne
Vonnoh	Robert
Voss	Johannes
Voysey	CFA
Vroom	Hendrick Cornelisz
Vrubel	Mikhail
Wadsworth	Edward
Wain	Louis
Walala	Camille
Walker	David
Walker	Kara
Walker	Nick
Walker	Tim
Wall	Jeff
Wall	Josephine
Wallis	Eric
Wallis	Karen
Walotsky	Ron
Ward	Bill
Ward	Lynd
Ward	Pendleton
Wardle	Arthur
Ware	Chris
Warhol	Andy
Waterhouse	John William
Watkiss	John
Watrous	Harry
Watteau	Jean-Antoine
Watterson	Bill
Watts	George Frederic
Watts	James Thomas
Waugh	Frederick Judd
Weber	Max
Webster	Walter Ernest
Weeks	Edwin Lord
Weems	Carrie Mae
Wegener	Gerda
Wegman	William
Wei	Li
Weldon	Casey
Welliver	Neil
Welz-Stein	Catrin
Wenders	Wim
Wendt	William
Wenner	Kurt
Wesely	Michael
Wesselmann	Tom
Wessing	Taylor
Weston	Brett
Weston	Edward
Westwood	Vivienne
Whalen	Tom
Whelan	Michael
Whistler	James Abbott McNeill
White	Tim
Whiteley	Brett
Whiteread	Rachel
Whitmore	Coby
Whitten	Jack
Whittredge	Worthington
Wiesner	David
Wiggins	Guy Carleton
Wileman	Peter
Wiley	Kehinde
Wilhelm	John
Wilk	Emilia
Wilkinson	Arthur Stanley
Williams	Gilbert
Williams	Kyffin
Williams	Robert
Williamson	Al
Willink	Carel
Winkelmann	Mike
Winogrand	Garry
Winterhalter	Franz Xaver
Wirth	Nathan
Wittfooth	Martin
Wittmann	Klaus
Woelfel	Brandon
Wolstenholme	Jonathan
Wong	Liam
Wonner	Paul
Wood	Ashley
Wood	Grant
Woodman	Francesca
Woodring	Jim
Woodroffe	Patrick
Woodruff	Hale
Worrall	Mike
Wray	William
Wright	Frank Lloyd
Wrightson	Bernie
Wu	Bayard
Wu	Tooth
Wyeth	Andrew
Wyeth	N.C.
Wyspiański	Stanisław
Xuan	Qian
Yamamoto	Takato
Yang	Gene Luen
Yarrow	David
Yasunari	Ikenaga
Ye	Liu
Yeats	Jack Butler
Yeats	John Butler
Yerka	Jacek
Yermolova	Iryna
Yiadom-Boakye	Lynette
Yoon	Dain
Yoro	Sean
Yoshida	Akihiko
Yoshida	Hiroshi
Yoshii	Chie
Yoshioka	Tokujin
Youll	Stephen
Young	Skottie
Yue	Xiaofei
Yuon	Konstantin
Yuumei	N/A
Zabaleta	Rafael
Zacharevic	Ernest
Zadkine	Ossip
Zagar	Isaiah
Zatzka	Hans
Zdarsky	Chip
Zener	Eric
Zenin	Igor
Zhen	Chen
Zhong	Fenghua
Zhuravleva	Anka
Zirnite	Nele
Zorach	William
Zorn	Anders
Zumthor	Peter
Zupa	Ravi
Aagaard	Zacharias Martin
Aaltonen	Wäinö
Abbott	Elenore
Abe	Yoshitoshi
Adams	Scott
Adams	Tracey
Afshar	Petros
Aida	Makoto
Al Gazzar	Abdel Hadi
Al Halyan	Moosa
Albani	Francesco
Alexander	Lena
Allers	Christian Wilhelm
Allinson	Adrian Paul
Amani	Charly
Amano	Yumihiko
Amaringo	Pablo
Ancher	Helga
Angus	Glen
Anno	Moyoco
Antigna	Alexandre
Aoki	Shigeru
Aoyama	Tokio
Arakawa	Hiromu
Arinouchkine	Andréi
Arms Botke	Jessie
Aronson	David
Art	Kubisi
Asghar	Anas
Auffray	Marie-Thérèse
Avon	John
Avril I	Jean-Jacques
Aydogdu	Aykut
Baizley	John
Balbusso	Anna and Elena
Barbucci	Alessandro
Barceló	Tomàs
Barra	Didier
Barton	Del Kathryn
Bashkirtseff	Marie
Baskin	Leonard
Basset	Françoise
Battiss	Walter
Bauck	Joanna
Bawa	Manjit
Bechtle	Robert
Becker	Florianne
Bedulenko	Max
Beihong	Xu
Belarski	Rudolph
Bell	Pedro
Bellange	Jacques
Bendre	Narayan Shridhar
Bennett	Joe
Benning	Richard
Berenstain	Jan
Berg	Aase
Bernea	Horia
Bhattacharjee	Bikash
Biddle	George
Bissette	Stephen
Blanché	Pascal
Blasingame	Marguerite
Bleyl	Fritz
Bliss	Stephen
Bloch	Albert
Bloom	Hyman
Blume	Peter
Bocchio	Carlo
Bodo	Camille-Pierre Pambu
Bogen	Alexander
Bogomazov	Oleksandr
Bolton	John
Bonner	Paul
Bonson	Tom
Boquet	François
Bouzianis	George
Brauer	Arik
Bredenbekk	Børge
Breton	Elisa
Bridgwater	Emmy
Britenbucher	Renie
Brosnan	Pierce
Brundage	Margaret
Buffet	Warren
Bush	George
Buzzelli	Guido
Calder	Alexander Milne
Campendonk	Heinrich
Caniglia	Jeremy
Cantone	Giovanni Gabriele
Canty	Thomas
Carbonell	Nacho
Caron	Marcel
Carreño de Miranda	Juan
Carte	Anto
Castiglione	Giovanni Benedetto
Catargi	Henri
Cawén	Alvar
Cearley	Clint
Chan	Pierre-Mony
Chebokha	Artem
Chernik	Echo
Chevalier	Li
Chin	Zeen
Chuangxing	Zeng
CLAMP	N/A
Coolidge	Cassius Marcellus
Copley	William
Costa	Giovanni (Nino)
Cotton	Brent
Crawford	Ralston
Cronenberg	David
Cross	Peter
Croy	Peter
Csontváry Kosztka	Tivadar
Currie	Justin
da Silva	João Artur
Dąbrowski	Kazimierz
Dale	Jeremy
Damast	Elba
Das	Sunil
Davis	Alan
Day	Anthony
de Critz	Emmanuel
De Nomé	François
De Ro	Jonas
De Smet	Gustave
de Souza-Cardoso	Amadeo
Death Burger	N/A
del Barco	Jesús Meneses
Deschamps	Eric
Desiderio	Monsù
Deyneka	Aleksandr
Di Cavalcanti	Emiliano
Djukaric	Dusan
Dobuzhinsky	Mstislav
Dohanos	Stevan
Domaradzki	Grzegorz
Domínguez	Óscar
Donghi	Antonio
Dongjun Lu	Russell
Dossena	Emilio Giuseppe
Dottori	Gerardo
Dros	Alberto
Dulac	Germaine
Dulbecco	Gian Paolo
Dupas	Jean
Durán	Victorina
Dvořák	František
Eckhardt	Danielle
Eckhout	Albert
Eibatova	Karine
Elder	Collin
Ellenshaw	Harrison
Elliott	Harold
Ellison	Charles
Eloy	Mário
Éluard	Nusch
Embleton	Ron
Embry	Norris
Engström	Leander
Ernst	Jimmy
Evergood	Philip
Fahrenkrog	Ludwig
Faithfull	Andrew Boog
Fautrier	Jean
Fedosav	Alexander
Fegredo	Duncan
Fein	Sylvia
Felixmüller	Conrad
Fernández	Agustín
Fiebig	Frédéric
Filiger	Charles
Fitzpatrick	Art
Fjell	Kai
Flowers	Hannah
Flynn	Danny
Foujita	Tsuguharu
Francés	Victoria
Frenchy	N/A
Friese	Richard
Friesz	Othon
Fukuzawa	Ichiro
Fumito	Ueda
Gahō	Hashimoto
Garnelo	José
Garney	Ron
Gascar	Henri
Gassler	Josef
Gerstl	Richard
Gibran	Kahlil
Gierymski	Aleksander
Gimel	Georges
Giménez	Juan
Goeritz	Mathias
Goldblatt	Lydia
Gomez	Pablo Munoz
Gonzalez	Rodel
Gotlib	Henryk
Goyo	Hashiguchi
Greene	Milton H.
Grey	Allyson
Griepenkerl	Christian
Grimmer	Jordan
Gritchenko	Alexis
Grubaugh	Carson
Grünewald	Isaac
Guangjian	Huang
Gustafson	Scott
Häfner	Thomas
Haker	Matthias
Hákonarson	Einar
Hamiti	Bess
Hammer	Victor
Han	Yeong-Hao
Hara	Tetsuo
Harlamoff	Alexei
Hausner	Rudolf
Hawker	Thomas
Hawkins	Emery
Heath	Dave
Heijermans	Hubertine
Hem	Andrew
Henrichon	Niko
Herzog	Werner
Hester	Joy
Higgins	John
Hinterreiter	Hans
Hirano	Kouta
Hofer	Karl
Hofhuizen	Willem
Hollósy	Simon
Hong	Kuang
Hongzhong	Gu
Hordiienko	Tatiana
Hugo	Valentine
Huss	Judson
Hutty	Alfred Heber
Ida	Yukimasa
Ingels	Graham
Ingle	John Stuart
Isak	Gabriel
Ishida	Tetsuya
Ishiguro	Ayako
Jaakola	Alpo
Jacovleff	Alexandre
Jakuchū	Itō
Jaśnikowski	Jarosław
Jasso	Jaime
Jedruszek	Tomasz
Jespers	Floris
Jethani	Saurabh
Jodorowsky	Alejandro
Johansen	Einer
Johnston	Miles
Jones	Eddie
Jones	J. G.
Jones	Lois Mailou
Jonson	Sven
Jung	Tom
Kamoi	Rei
Kanitz	Felix Philipp
Kanoldt	Alexander
Katsura	Yuki
Katsuragawa	Hiroshi
Kawacy	N/A
Keane	Bil
Keane	Jeff
Keel	Carl Eugen
Keene	Lisa
Kelly	Felix
Kelly	Patrick
Kelsner	Alfred
Kernn-Larsen	Rita
Kidner	Michael
Kieryluk	Igor
Kimball	Ward
King	Tom
Kinkaid	Thomas C.
Kirkman	Robert
Klinger	Max
Knutson	Greta
Kochabua	Prateep
Koga	Harue
Koike	Takeshi
Kondo	Kazuhisa
Kopinski	Karl
Korolev	Oleg
Kotarbiński	Wilhelm
Kotin	Albert
Kōzan	Makuzu
Krenkel	Roy
Kruyder	Herman
Kuindzhi	Arkhyp
Kuksi	Kris
Kutsche 	Michael 
Labisse	Félix
LaBrooy	Chris
Ladrönn	José
Lady Gaga	N/A
Laloux	René
Laubser	Maggie
Le	John
Leblanc	André
Lebrun	Rico
Ledesma	Clara
Lee	Joong Keun
Lee	Stan
Lefèbvre	Claude
Lefevre	Vincent
Lefler	Franz
Lehmbruck	Wilhelm
Levine	Jack
Liberto	John
Limon	Jason
Lockwood	Todd
Logsdail	William
Lohse-Wächtler	Elfriede
Lovag	Antti
MacFarlane	Seth
Maeda	Mahiro
Mägi	Konrad
Magnaldo	Alastair
Magnelli	Alberto
Maguire	Robert
Malfatti	Anita
Malkin	David
Mallo	Maruja
Mambour	Auguste
Manabe	Johji
Manini	Jack
Manookian	Arman
Mansour	Sliman
Marcela-Froideval	François
Marchetti	Lou
Martchenko	Michael
Maruo	Suehiro
Masaharu	Takasaki
Masons	Keos
Maurer	Alfred Henry
Maya	Rubén
Mayle	Sam
McCoy	Jon
McKinnon	Seb
Medková	Emila
Mehoffer	Józef
Meidner	Ludwig
Melan	Claude
Meller	Vadim
Miller	Lee
Miller	Ron
Minguez	Victor Adame
Mintchine	Abraham
Moline	Robin
Moonan	John
Moore	Marcel
Morimoto	Kōji
Morsi	Ahmed
Mosquera	Victor
Mr. Doodle	N/A
Mueller	Otto
Müller	Otto
Munsch	Robert
Musashi	Miyamoto
Musgrove	Scott
Myers	Ed
Nagualero	Ric
Nakai	Tsubasa
Nakian	Reuben
Nash	John
Nesch	Rolf
Nielsen	Terese
Nightow	Yasuhiro
Normal	David
Norman	Max Magnus
Norman	Polly
Northrup	Don
Northrup	Tony
Northup	Don
Oga	Kazuo
Ōi	Katsushika
Oka	Yasutomo
Okamoto	Tarō
Okawara	Kunio
Ōkyo	Maruyama
Olbiński	Rafał
Oldham	Brian
Onchi	Kōshirō
Or	Hinchel
Orbik	Glen
Ortega	Gilberto Hernández
Ortiz	Karla
Ossola	Raffeaello
Ōtsuji	Kiyoji
Otus	Erol
Ozenfant	Amedee
Paalen	Wolfgang
Palencar	John Jude
Panikanova	Ekaterina
Papazoff	Georges
Paquette	Adam
Parker	Jake
Parker	Lisa
Parthenis	Konstantinos
Pass	Donald
Paul	Gen
Penrose	Valentine
Petagno	Joe
Petruk (APe)	Alex
Philipon	Charles
Picenardi	Mauro
Pimenov	Yuri Ivanovich
Pinker	Stanley
Pitt	Suzan
Podolchak	Ihor
Pollem	Samson
Pomodoro	Arnoldo
Pontet	Cyril
Powers	Richard M.
Poyser	Victoria
Prezio	Victor
Prins	Theo
Purser	Sarah
Pushwagner	Hariton
Quevedo	Carlos
Quiller	Stephen
Quirt	Walter
Qwek	Dom
Ranpo	Edogawa
Rapmund	Norm
Rapoza	Dave
Rattner	Abraham
Ravanetti	Elias
Ravelo	Mars
Razumovskaya	Anna
Rebelka	Jakub
Reindel	Edna
Reopel	Joyce
Rezaei	Aminollah
Rhoades	Jason
Riley	John
Rimmington	Edith
Ringwood	Bob
Riou	Édouard
Rixens	Jean-André
Robida	Albert
Robinson	Alex
Rolick	Esther
Rosemont	Penelope
Rosenstein	Erna
Rousseau	Theodore
Roy	Pierre
Roybal	Antonio
Runyan	Pablo
Ryky	N/A
Sack	Benjamin
Saga	Soraya
Sakimichan	N/A
Sallinen	Tyko
Sanderson	Ruth
Sandoval	Tony
Sasselli	Davide
Schawinsky	Xanti
Schepacz	Yohann
Schnackenberg	Walter
Schoenberg	Arnold
Schomburg	Alex
Schuler	Théophile
Schwertberger	De Es
Segall	Lasar
Sekine	Nobuo
Sekoto	Gerard
Selimoglu	Niyazi
Senosiain	Javier
Serafini	Luigi
Servaes	Albert
Setowski	Tomek
Shaw-Lawrence	Bettina
Shimamoto	Julio
Shoulberg	Harry
Silva	Emerson
Silva	Samuel
Siudmak	Wojciech
Skizhali-Weiss	Arthur
Sluyters	Jan
Small	Jane
Smeeth	Peter
Smith	Michael James
Smith	Samuel
Sorel	Guillaume
Spriggs	Ian
Starowieyski	Franciszek
Starr	Leonard
Sternberg	Harry
Sudworth	Anne
Sugiura	Hisui
Sultan Mohammed	N/A
Summers	Scott Samuel
Sustermans	Justus
Švankmajerová	Eva
Sykut	Andrzej
Tábara	Enrique
Tacito	Franck
Taga	Shin
Takeda	Sana
Takeji	Fujishima
Takeya	Takayuki
Tam	Vivienne
Tanaka	Suguru
Tanaka	Tatsuyuki
Tang	Sandara
Tarnowski	Artur
Tassi	Agostino
Tatsushima	Yuko
Télémaque	Hervé
Teng	Chuah Thean
Tertychnyi	Eugene
Tessari	Vittorio
Thirion	Charles Victor
Thornton	Robert John
Tiefu	Li
Törneman	Axel
Toyen	N/A
Trouille	Clovis
Tucker	Albert
Ugarte	Jean-Pierre
Urlich	Philipp
Valetova	Nina
Valigursky	Ed
van Ravesteyn	Jan
Van Suddese	Kate
Vargas	Randy
Velez	Walter
Velinov	Svetlin
Venosa	Robert
Veprikov	Nikita
Vergvoktre	N/A
Vicente	Esteban
Vishnevsky	Dmitry
Vohwinkel	Franz
Voligamsi	Rinat
von Pettenkofen	August
Wagner	Matt
Waldberg	Isabelle
Walker	John
Walker	Robert
Walpole	Tyler
Wänerstrand	Tom
Watanabe	Junya
Weber Furlong	Wilhelmina
Weenix	Jan
Weiwei	Ai
Werkman	H.N.
White	Charles
Wiegers	Jan
Wiiralt	Eduard
Williams	Allen
Wilson	G. Willow
Witkiewicz	Stanisław Ignacy
WLOP	N/A
Wooten	Ben
Wurm	Edwin
Xandt	Hedi
Yang	J
Yanner	Kieran
Yasuhiko	Yoshikazu
Yatate	Hajime
Yazawa	Ai
Yoshitoyo	Fujii
Yoshiyasu	Tamura
Youll	Paul
Younan	Ramses
Zabrocki	Darek
Zacherle	Bonnie
Zand	Amir
Zangana	Haifa
Zaragoza	Gilberto Soren
Zawadzki	Dariusz
Zerbe	Karl
Ziewe	Jurgen
Ziraldo	Lorena
Ziraldo	N/A
Zürn	Unica
Скижали-Вейс	Артур
base prompt only	N/A
Chung	Peter
Cinar	Yildiray
Del Rio	Eddie
Faithorne	William
Falconet	Étienne Maurice
Gallen-Kallela	Akseli
Lefou	Auguste
Matsui	Fuyuko
Pelissero	Silvia
Bellows	George
Clairin	Georges
de Dienes	Andre
de Madrazo y Garreta	Raimundo
de Zurbaran	Francisco
Endel	Ingrid
Everhart	Tom
Daeni	Pino
Gagnon	Clarence
Galien-Laloue	Eugene
Garant	Alex
Gesell	Stefan
Haacke	Hans
Haenraets	Willem
Hajjaj	Hassan
Harris	Henrietta
Käsebier	Gertrude
Kasparavicius	Kestutis
Katz	Alex
Kawauchi	Rinko
Lee	JeeYoung
Leiter	Saul
Lely	Peter
Mann	David
Masaccio	N/A
Mashkov	Ilya
Matejko	Jan
Panter	Gary
Peploe	Samuel
Petrov-Vodkin	Kuzma
Rogers	Henri (Henry)
Rokkaku	Ayako
Sekowsky	Mike
Thomas	Nene
Thompson	Craig
Verner	Frederick Arthur
Wong	Ina
Beyit	Kerem
Dos Santos	Dan
Driggs	Elsie
Gabbiani	Anton Domenico
Komarck	Michael
Komatsu	Miwa
Rohlfs	Scott
Roiland	Justin
Segal	George
Selbach	Victoria
Seliger	Mark
Soejima	Shigenori
Thomas	Alma Woodsey
Timlin	William
Vasquez	Jhonen
Veasey	Nick
Vereshchagin	Vasily
Wiltshire	Stephen
Wimberly	Ronald
Witz	Dan
Ploog	Mike
Baseman	Gary
Bevacqua	Marta
Bianchi	Simone
Biasi	Alberto
Collier	John
Collins	Ray
Colville	Alex
Condo	George
Douglas	Aaron
Downton	David
Faurer	Louis
Fildes	Luke
Flore	Maia
Grummett	Tom
Guanzhong	Wu
Guardi	Francesco
Guay	Sam
Hettinger	David
Hicks	George Elgar
Hicks	Petrina
Hicks	Sheila
Konchalovsky	Pyotr
Kopera	Tomasz Alen
Lin	Maya
Lindbergh	Peter
Lippmann	Peter
Lismer	Arthur
Morley	Lewis
Morris	Sarah
Morrison	Grant
Morrison	John Lowrie
Pousette-Dart	Richard
Poussin	Nicolas
Poynter	Edward
Pradier	James
Rothschild	Eva
Roukes	Joram
Roulland	Dimitry
Rudolph	Paul
Shimamoto	Shozo
Shimizu	Yuko
Shimomura	Kanzan
Shinohara	Tamotsu
Tatlin	Vladimir
ter Brugghen	Hendrick
Teraoka	Masami
Terpning	Howard
Viertel	Gabriele
Villeneuve	Magali
Vilstrup	Signe
Visconti	Eliseu
Wright	Richard
Wtewael	Joachim
Wylie	Rose
Wysocki	Charles
Tom of Finland	N/A
Yata	Hannah
Bá	Gabriel
Billy	Butcher
Bing	Ilse
Bing	Xu
Bingham	George Caleb
Cartier-Bresson	Henri
Catesby	Mark
Catlett	Elizabeth
Catlin	George
Dauterman	Russell
David	Jacques-Louis
Delaney	Janet
Delaunay	Robert
Granz	Matt
Gray	Eileen
Greene	Balcomb
Greenfield	Lois
Heighton	Brent
Hein	Jeppe
Helfer	Fay
Henri	Robert
Jungen	Brian
Kahila	Janne
Kar-wai	Wong
Karimova	Elina
Ledent	Pol
Ledroit	Olivier
Lee	Minjae
Lemmen	Georges
Loish	N/A
Long	Richard
Longhurst	Kathrin
Lorrain	Claude
Mauve	Anton
Maxence	Edgar
Mayne	Thom
McAllister	Cristina
Pinkney	Jerry
Pinturicchio	N/A
Piot	Étienne Adolphe
Pishtar	Julia
Rossbach	Jean-Sebastien
Runge	Philipp Otto
Rungius	Carl
Rusinol	Santiago
Scher	Paula
Schikaneder	Jakub
Schinkel	Karl Friedrich
Schlemmer	Oskar
Trimpe	Herb
Trumbull	John
Tsang	Johnson
Tuke	Henry Scott
Vettriano	Jack
Vivier	Camille
Võ	Danh
von Aachen	Hans
Wilkes	Cathy
Wilkins	Edward Blair
Wilkins	Sophie
Willers	Heike
Baade	Carrie Ann
Bachalo	Chris
Bachelier	Anne
Baes	Firmin
Baheux	Laurent
Bailey	David
Barney	Matthew
Benscoter	Wes
Benton	Thomas Hart
Bergland	Don
Bergsma	Jody
Billingham	Richard
Birch	Thomas
Birrell	George
Bissell	Robert
Blacklock	William Kay
Blake	Peter
Blakelock	Ralph
Blanding	Don
Blish	Carolyn
Blish	Carolyn
Blumenfeld	Erwin
Bocek	Anna
Bogle	Lee
Boily	Louis-Léopold
Boldini	Giovanni
Bolland	Brian
Boltanski	Christian
Bone	Tami
Bonheur	Rosa
Bonington	Richard Parkes
Bontecou	Lee
Borremans	Michael
Botero	Fernando
Boucher	François
Boughton	George Henry
Bouvattier	Annick
Bowers	David Michael
Bracht	Eugen
Brack	John
Bramley	Frank
Brandt	Bill
Braque	Georges
Brassaï	N/A
Brayne	David
Brendekilde	Hans Andersen
Breslauer	Marianne
Breton	Jules
Breuer	Marcel
Bridgman	Frederick Arthur
Brigman	Anne
Bronzino	N/A
Brood	Herman
Brooks	Romaine
Brooks	Troy
Broom	Lee
Brosh	Allie
Brown	Cecily
Browning	Rob
Brueghel the Elder	Jan
Brueghel the Younger	Pieter
Brunet	Marc
Bruno	Nicolas
Bruyn the Elder	Barthel
Bruyn the Younger	Barthel
Bua	Justin
Buchet	Philippe
Buckman	Zoe
Bujnowski	Leszek
Bullough	James
Bunny	Rupert
Bunt	Gary
Burgerman	Jon
Burgert	Jonas
Burns	Charles
Burri	Rene
Burrington	Stasia
Buscema	John
Busciglio	Nicholas
Busiek	Kurt
Byam Shaw	N/A
Byars	James Lee
Cadmus	Paul
Caffery	Debbie Fleming
Caffi	Ippolito
Caillebotte	Gustave
Caliari	Benedetto
Callaghan	George
Calleri	Fred
Callis	Jo Ann
Camargo	Iberê
Campbell	J. Scott
Camuncoli	Giuseppe
Capullo	Greg
Carr	Emily
Carriera	Rosalba
Carrington	Leonora
Carter	Keith
Cattelan	Maurizio
Cazneaux	Harold
Ceccoli	Nicoletta
Cecile	Agnes
Chen	Bo
Cheret	Jules
Chiang	Cliff
Chiang	Doug
Chihuly	Dale
Childs	Casey
Cho	Michael
Choe	David
Choultse	Ivan Fedorovich
Christakis	George
Clausen	George
Clemente	Francesco
Clergue	Lucien
Cloonan	Becky
Closterman	John
Clottey	Serge Attukwei
Clowes	Daniel
Coburn	Alvin Langdon
Cocteau	Jean
Coffin	Clifford
Colbert	Gregory
Cold	Chris
Colen	Dan
Coll	Joseph Clement
Colla	Eddie
Colletta	Vince
Conklin	Beth
Coomber	Yvonne
Coppedge	Fern Isabel
Correll	Gemma
Cortes	Eduard
Cortright	Petra
Costa the Elder	Lorenzo
Costa the Younger	Lorenzo
Cotman	John Sell
Cotton	Olive
Coverly	Dave
Coville	Bruce
Cowper	Frank Cadogan
Craft	Kinuko Y.
Cragg	Tony
Craig-Martin	Michael
Crain	Clayton
Cranach the Younger	Lucas
Creed	Martin
Creese	Michael
Crome	John
Crook	PJ
Cropsey	Jasper Francis
Crosby	Njideka Akunyili
Crowther	Jane
Cruz-Diez	Carlos
Cucuel	Edward
Curran	Charles Courtney
da Messina	Antonello
da Rimini	Pietro
Danish	Dmitri
Danziger	Jeff
Darbishire	Stephen
Dargas	Mike
Demarchelier	Patrick
Demsteader	Mark
Demuth	Charles
Denis	Maurice
Dewing	Thomas
di Cosimo	Piero
diCorcia	Philip-Lorca
DiDonato	Brooke
Dieckmann	Sandra
Digalakis	George
Dine	Jim
Ditlev	Jan
Dixon	Maynard
Dodson	Terry
Dolci	Carlo
Domenichino	N/A
Domergue	Jean-Gabriel
Dorr	Nell
Drossin	Jessica
du Puigaudeau	Ferdinand
Dubbeldam	Ton
Dubois-Pillet	Albert
Duccio	N/A
Dufy	Raoul
Dumas	Marlene
Dunbar	Evelyn
Durgin	Bill
Dwyer	Charles
Dyer	Chris
Gaertner	Eduard
Gillray	James
Gilman	Harold
Ginner	Charles
Giraud	Eugène
Glackens	William James
Gleizes	Albert
Glendinning	Lucy
Gonzalez-Torres	Felix
Gormley	Antony
Gottardo	Alessandro
Gottlieb	Adolph
Granov	Adi
Griffin	Rick
Griffiths	Mitch
Grimly	Gris
Groh	Boris
Gross	Alex
Grossmith	Lucy
Guayasamin	Oswaldo
Guercino	N/A
Guillemin	Grégoire
Guillory	Rob
Guillot	Laure Albin
Guillou	Alfred
Guimard	Hector
Guo-Qiang	Cai
Guyton	Wade
Hawkins	Louis Weldon
Hawkinson	Tim
Hayashida	Q
Hayez	Francesco
Hefferan	Rob
Heiden	Jamie
Henson	Mark
Herbin	Auguste
Hergé	N/A
Herrero	Lowell
Hersey	Edward
Hescox	Richard
Hesse	Eva
Hido	Todd
Hill	Kevin
Hillenburg	Stephen
Hilliard	Nicholas
Hiroshige	N/A
Hirsch	Alex
Hirshfield	Morris
Hirst	Damien
Hitch	Bryan
Ho	Fan
Hobbema	Meindert
Hobbie	Jocelyn
Hocks	Teun
Hoffman	Martina
Hofmann	Hans
Hoisel	Tiago
Holbein the Elder	Hans
Holbein the Younger	Hans
Holcroft	John
Holland	Jim
Holler	Carsten
Holloway	Lisa
Holloway	Zena
Holtz	Tim
Hondius	Hendrik
Hoong	Tang Yau
Hopkins	Thurston
Hopper	Erica
Horn	Roni
Horst	Horst P.
Horta	Victor
Howard	Ken
Howie	Malcolm
Howitt	Alex
Howorth	Ian
Huang	Shilin
Hughes	Adam
Hughes	Jack
Hughes	Nicholas
Hughes	Talbot
Hume	Gary
Hurrell	George
Husain	M.F.
HUSH	N/A
Hussar	Michael
Hutchinson	Nicholas Hely
Hutton	Kurt
Huyghe	Pierre
Kenna	Michael
Kertész	André
Keyes	Josh
Kim	Sung
Kingsley	Harry
Kirchner	Raphael
Kisling	Moise
Kittelsen	Theodor
Kjartansson	Ragnar
Knight	Kris
Knight	Louis Aston
Knights	Winifred
Knorr	Karen
Kochar	Yervand
Koitsu	Tsuchiya
Kolins	Scott
Koson	Ohara
Kostabi	Mark
Kote	Josef
Kozloff	Joyce
Krull	Germaine
Kubert	Joe
Kubicki	Jarek
Kurasov	Georgy
Kurtzman	Harvey
Kustodiev	Boris
Laboile	Alain
Lachaise	Gaston
Lebasque	Henri
Leclerc	Raynald
Lemmer	Alayna
Lenoir	Charles-Amable
Lentulov	Aristarkh
Leroy	Eugene
Lettl	Wolfgang
Leuthard	Thomas
Levers	Andreas
Levitt	Helen
LeWitt	Sol
Leyendecker	Frank Xavier
Leyster	Judith
Libeskind	Daniel
Lie	Jonas
Lieske	Daniel
Lifsches	Iwona
Lissitzky	El
Lively	Jim
Lobanov	Ruslan
Locher	Olivia
Lockertsen	Nikolai
Loiseau	Gustave
Loughridge	Lee
Louis	Morris
Lourenço	Didier
Lowry	L. S.
Lubalin	Herb
Lucas	Sarah
Luepke	Heiner
Lurie	John
Luttichuys	Simon
Lynes	George Platt
MacDonald	Frances
Mackey	Stephen
Maillol	Aristide
Makart	Hans
Manalo	Michael Vincent
Mancini	Antonio
Manev	Marko
Mankes	Jan
Mann	Clay
Manzanedo	Antonio J.
Marchuk	Ivan
Margetson	William Henry
Matsuyama	Tomokazu
Maufra	Maxime
McCarthy	Frank
McCay	Winsor
McCloud	Scott
McCracken	Craig
McCubbin	Frederick
McCurry	Steve
McGee	Barry
McGuinness	Norah
McGuinness	Tom
McHale	Patrick
Mckadesinsanity	N/A
McKay	Philip
McKenney	Christopher Ryan
Mckinstry	John
McLellan	Alasdair
McNaught	Jon
McNeal	Kevin
McQueen	Alexander
Meese	Jonathan
Mehretu	Julie
Meier	Richard
Meisel	Steven
Meissonier	Ernest
Melchers	Gari
Mellin	Charles
Melmoth	Emil
Memling	Hans
Mengs	Anton Raphael
Merle	Hugues
Messely	Johan
Metlan	Anatoly
Metsu	Gabriel
Metzker	Ray
Meyerowitz	Joel
Middlebrook	Jason
Milan	Dimitra
Millais	John Everett
Millar	Alexander
Miller	Richard E.
Millet	Francis Davis
Milne	David Brown
Minter	Marilyn
Miralles	Januz
Misrach	Richard
Mitchell	Joan
Mitchell	Kirsty
Mitchev	Peter
Miyajima	Tatsuo
Model	Lisette
Molin	Benoît-Hermogaste
Moll	Carl
Molloy	Matt
Monsted	Peder Mork
Mora	Antonio
Moran	Edward
Morandi	Giorgio
Morisot	Berthe
Morland	George
Moser	Koloman
Mosse	Richard
Mostyn	Thomas Edwin
Mould	David
Mouly	Marcel
Muniz	Vik
Murata	Range
Pacheco	Gabriel
Packard	Anne
Page	Michael
Pettibon	Raymond
Phillips	Richard
Piccinini	Patricia
Pich	Sopheap
Piene	Otto
Pieters	Nelleke
Pinke	Veronika
Pistoletto	Michelangelo
Plock	Ferris
Plowden	David
Pongiluppi	Guillem H.
Poons	Larry
Porter	Fairfield
Potocki	Gail
Potthast	Edward Henry
Pratt	Hugo
Preston	Margaret
Pui-Mun Law	Stephanie
Puryear	Martin
Putz	Leo
Ratzeburg	Julius Theodor Christian
Relander	Christoffer
Rheims	Bettina
Rhodan	Perry
Rhodes	Matt
Rive	Max
Roberts	Danny
Roberts	Slade
Robinson	Theodore
Robison	Joel
Rocafort	Kenneth
Rone	N/A
Rops	Felicien
Rosa	Salvator
Rosanes	Kerby
Rose	Guy
Rosenquist	James
Ruskin	John
Ruysch	Rachel
Sack	Steve
Safin	Marat
Safronow	Wlad
Sarnoff	Arthur
Scheiner	Artus
Schenck	August Friedrich
Schmid	Richard
Schnabel	Julian
Scholder	Fritz
Schongauer	Martin
Scott	Richard T.
Sears	Bart
Sedgley	Peter
Senatore	Edmondo
Serra	Richard
Sérusier	Paul
Severin	Marie
Severini	Gino
Shainblum	Michael
Shapcott	Michael
Sharp	Dorothea
Shatseva	Tanya
Shawcross	Conrad
Sheeler	Charles
Shek	Chung
Shengxian	Qiu
Sheri	Irene
Sheridan	Duffy
Shinsui	Ito
Shiraga	Kazuo
Shortridge	Stephen
Shuplyak	Oleg
Shuxing	Li
Sibthorp	Fletcher
Sickert	Walter
Sidar	Ebru
Sidibé	Malick
Signac	Paul
Silvers	Robert
Sime	Sidney
Simone	Gail
Simpson	Jeff
Sims	David
Siqueiros	David Alfaro
Siskind	Aaron
Sisley	Alfred
Siyah-Kalem	Mehmed
Siza	Álvaro
Slimane	Hedi
Sloane	John
Smart	Jeffrey
Smith	Jeff
Smith	Rodney
Smith	Samantha Keely
Smith	W. Eugene
Smithson	Robert
Snyders	Frans
Sobas	Marcin
Sohlberg	Harald
Sokolsky	Melvin
Soleri	Paolo
Solimena	Francesco
Solomon	Barbara Stauffacher
Somov	Konstantin
Sonrel	Elisabeth
Sorrenti	Davide
Sorrenti	Mario
Soth	Alec
Soto	Jeff
Soulages	Pierre
Souza	Francis Newton
Soyer	Moses
Soyer	Raphael
Spangler	Randal
Sparre	Kylli
Spencer	Jack
Spencer	Stanley
Spilliaert	Leon
Spiros	Dmitry
Spratt	Sam
Springer	Cornelis
Staelens	Christophe
Staples	Greg
Staprans	Raimonds
Steen	Jan
Stefanescu	George
Stein	Fred
Stein	Harvey
Steinberg	Saul
Steinlen	Théophile
Steinmetz	Mark
Steir	Pat
Stern	Bert
Stern	Grete
Stettner	Louis
Stevens	Alfred
Stieler	Joseph Karl
Still	Clyfford
Stock	Dennis
Stokes	Marianne
Stoller	Ezra
Stone	Chase
Stranka	Martin
Strino	Gianni
Strozzi	Bernardo
Strudwick	John Melhuish
Stuck	Franz
Styrsky	Jindrich
Sugar	Rebecca
Sughi	Alberto
Suh	Do Ho
Sullivan-Beeman	Deirdre
Sully	Thomas
Sung	Janice
Surfleet	Leanne
Suschitzky	Wolfgang
Sutkus	Antanas
Sviridova	Myroslava
Sweerts	Michael
Swinstead	George Hillyard
Szynkarczuk	Jacek
Taaffe	Philip
Timmermans	Alex
Titcomb	Mary Bradish
Tobey	Mark
Tocchini	Greg
Tomaselli	Fred
Toorop	Jan
Topor	Roland
Toppi	Sergio
Toraji	N/A
Totleben	John
Toulmouche	Auguste
Tremblay	Claudia
Tresoldi	Edoardo
Tress	Arthur
Tunick	Spencer
Tunnicliffe	Charles
Turbeville	Deborah
Turner	William
Tuttle	Richard
Tutwiler	David
Twachtman	John Henry
Tydeman	Naomi
Vaikuntam	Thota
Valeza	Brian
Vallotton	Felix
van de Velde	Esaias
van der Hamen	Juan
Van der Ouderaa	Pierre Jean
van der Weyden	Rogier
Verney-Carron	Antoine
Vesalius	Andreas
von Heyl	Charline
von Max	Gabriel
von Rydingsvard	Ursula
Vouet	Simon
Vuillard	Édouard
Wałkuski	Wiesław
Walpoth	Bruno
Weaver	Scott
Weiner	Lawrence
Weissenbruch	Hendrik
Welker	David
West	Franz
Wetter	Oliver
Whatson	Martin
Whitaker	William
Wiesenfeld	Aron
Wilson	Wes
Wood-Evans	Jake
Wool	Christopher
Wrede	Thomas
Yokoi	Kozo